#####################
#...................#
#...................#
#...................#
#...................#
#...................#
#...................#
#...................#
#.........C.C.......#
#..P.....T..T.......#
#######.........*...#
#####################