................................
................................
................................
......................CC........
......................T.........
.............................*..
......................T....#####
..P........................#####
####..T.T.............T....#####
####B........BB............#####
###########J ############J #####
################################