................................
................................
................................
................................
................................
.........#.#.#.#.#.#............
.........###########............
.........#.........#............
.........#.........#............
................................
.........S.........S............
.P...BB......B..B.....B.....*...
################################
################################