############################
#.......#..................#
#..........................#
#.......S..................#
#.................U........#
#.......T..................#
#....U............T........#
#.P.....T..................#
########..........T........#
##########.................#
#############WWWW####.F..*.#
############################
