.........................
......S...............S..
.........................
.........................
......S...............S..
.......BF.BB...F.........
......######I######II####
......#..X.....X..####...
.........................
........T...L............
.P.............C......*..
####J ###################
#########################
#########################