###########################
##    ###############     #
## S  ###############     #
##    ##############      #
#      ############       #
#         X    X          #
#                       * #
#                      ####
#          C           ####
# P        T         J ####
####      C  C       ######
########  #####  ##J ######
########FFFFFFFFF##########
###########################
###########################
###########################
